%%%%%%%
%P....%
%..%% %
%%%%%%%