%%%%%%%%%%%%%%%%%%%%%%%%%%%%%%%%%%%%%%%%
%P .......   ..      .......  ..    .. %
%  ..    ..  ..      ..    .. ..    .. %
%  ..    ..  ..      ..    ..  ..  ..  %
%  .......   ..      ......      ..    %
%  ..    ..  ..      ..          ..    %
%  ..     .. ....... ..          ..    %
%                                   G  %
%%%%%%%%%%%%%%%%%%%%%%%%%%%%%%%%%%%%%%%%